"filename", "language", "Python", "HTML", "JavaScript", "comment", "blank", "total"
"/Users/szymonkopycinski/Documents/Programming/Python/Unfinished Projects/Risk Tool NEFSIF/app.py", "Python", 7, 0, 0, 1, 2, 10
"/Users/szymonkopycinski/Documents/Programming/Python/Unfinished Projects/Risk Tool NEFSIF/databaseManager.py", "Python", -71, 0, 0, -3, -20, -94
"/Users/szymonkopycinski/Documents/Programming/Python/Unfinished Projects/Risk Tool NEFSIF/dbManagers/__init__.py", "Python", 0, 0, 0, 0, 1, 1
"/Users/szymonkopycinski/Documents/Programming/Python/Unfinished Projects/Risk Tool NEFSIF/dbManagers/loginManager.py", "Python", 71, 0, 0, 3, 20, 94
"/Users/szymonkopycinski/Documents/Programming/Python/Unfinished Projects/Risk Tool NEFSIF/dbManagers/portfolioManager.py", "Python", 57, 0, 0, 0, 19, 76
"/Users/szymonkopycinski/Documents/Programming/Python/Unfinished Projects/Risk Tool NEFSIF/risks/portfolio.py", "Python", 1, 0, 0, 0, 0, 1
"/Users/szymonkopycinski/Documents/Programming/Python/Unfinished Projects/Risk Tool NEFSIF/static/js/cumulative-performance-chart.js", "JavaScript", 0, 0, 6, 0, 0, 6
"/Users/szymonkopycinski/Documents/Programming/Python/Unfinished Projects/Risk Tool NEFSIF/static/js/monte-carlo-simulation-chart.js", "JavaScript", 0, 0, 3, 0, 0, 3
"/Users/szymonkopycinski/Documents/Programming/Python/Unfinished Projects/Risk Tool NEFSIF/templates/risk.html", "HTML", 0, -6, 0, 1, 0, -5
"Total", "-", 65, -6, 9, 2, 22, 92